⠀⠀⠀⠀⠀⠀⠀⠀⠀⠀⠀⠀⠀⠀⠀⠀⠀⠀⢀⠀⠀⠀⠀⠀⠀⠀⠀⠀⠀⠀⠀⠀⠀⠀⠀⠀
⠀⠀⠀⠀⠀⠀⠀⠀⠀⠀⠀⠀⠀⠀⠀⠀⠀⠀⡼⠀⠀⠀⠀⠀⠀⠀⠀⠀⠀⠀⠀⠀⠀⠀⠀⠀
⠀⠀⠀⠀⠀⠀⠀⠀⠀⠀⠀⠀⠀⠀⠀⠀⠀⣼⠇⠀⠀⠀⠀⠀⠀⠀⠀⠀⠀⠀⠀⠀⠀⠀⠀⠀
⠀⠀⠀⠀⠀⠀⠀⠀⠀⠀⠀⠀⠀⠀⠀⠀⠰⡏⠀⠀⠀⠀⠀⠀⠀⠀⠀⠀⠀⠀⠀⠀⠀⠀⠀⠀
⠀⠀⠀⠀⠀⠀⠀⠀⠀⠀⠀⠀⠀⠀⠀⠀⢰⡇⠀⠀⠀⠀⠀⠀⠀⠀⠀⠀⠀⠀⠀⠀⠀⠀⠀⠀
⠀⠀⠀⠀⠀⠀⠀⠀⠀⠀⠀⠀⠀⠀⠀⠀⢸⣷⡀⠀⠀⠀⠀⠀⠀⠀⠀⠀⠀⠀⠀⠀⠀⠀⠀⠀
⠀⠀⠀⠀⠀⠀⠀⠀⠀⠀⠀⠀⠀⠀⠀⠀⠀⢿⣷⡀⠀⠀⠀⠀⠀⠀⠀⠀⠀⠀⠀⠀⠀⠀⠀⠀
⠀⠀⠀⠀⠀⠀⠀⠀⠀⠀⠀⠀⠀⠀⠀⢀⠀⠈⢻⣿⣄⠀⠀⠀⠀⠀⠀⠀⠀⠀⠀⠀⠀⠀⠀⠀
⠀⠀⠀⠀⠀⠀⠀⠀⠀⠀⠀⠀⠀⠀⠀⠈⢆⠀⠀⠙⣿⣆⠀⠀⠀⠀⠀⠀⠀⠀⠀⠀⠀⠀⠀⠀
⠀⠀⠀⠀⠀⠀⠀⠀⠀⠀⠀⠀⠀⠀⠀⠀⠀⢧⠀⠀⠘⢿⣇⠀⠀⠀⠀⠀⠀⠀⠀⠀⠀⠀⠀⠀
⠀⠀⠀⠀⠀⠀⠀⠀⠀⠀⠀⠀⠀⠀⠀⠀⠀⣸⡆⠀⠀⠘⣿⡀⠀⠀⠀⠀⠀⠀⠀⠀⠀⠀⠀⠀
⠀⠀⠀⠀⠀⠀⠀⠀⠀⠀⠀⠀⠀⠀⠀⠀⣰⣿⠃⠀⠀⠀⣿⠇⠀⠀⠀⠀⠀⠀⠀⠀⠀⠀⠀⠀
⠀⠀⠀⠀⠀⠀⠀⠀⠀⠀⠀⠀⠀⠀⠀⣼⣿⠃⠀⠀⠀⠀⡿⠁⠀⠀⠀⠀⠀⠀⠀⠀⠀⠀⠀⠀
⠀⠀⠀⠀⠀⠀⠀⠀⠀⠀⠀⠀⠀⠀⠀⣿⡏⣀⣀⣀⠀⡜⠀⠀⠀⠀⠀⠀⠀⠀⠀⠀⠀⠀⠀⠀
⠀⠀⠀⠀⠀⠀⠀⣀⡤⠤⠒⠒⠋⠉⠉⠻⣧⠀⠀⠀⠈⠉⠁⠀⠀⠀⠢⢄⠀⠀⠀⠀⠀⠀⠀⠀
⠀⠀⠀⠀⠀⠀⣾⣿⠀⠀⠀⠀⣀⣀⣀⣀⣤⣽⣦⣄⣀⣀⣀⣀⠀⠀⠀⠀⢹⠀⠀⠀⠀⠀⠀⠀
⠀⠀⠀⠀⠀⠀⣿⣿⣿⠷⠾⠿⣿⣿⣿⣿⣿⣿⣿⣿⣿⣿⣿⣿⣿⡿⠶⠚⠀⠀⠀⠀⠀⠀⠀⠀
⠀⠀⠀⠀⠀⠀⢿⣿⡏⠀⠀⠀⠀⠀⠀⠈⠉⠉⠉⠉⠉⠉⠀⠀⠀⠀⠀⠀⠀⣸⠛⠻⣷⠀⠀⠀
⠀⠀⠀⠀⠀⠀⠸⣿⣧⠀⠀⠀⠀⠀⠀⠀⠀⠀⠀⠀⠀⠀⠀⠀⠀⠀⠀⠀⢀⠃⠀⢠⣿⠇⠀⠀
⠀⠀⠀⠀⠀⠀⠀⣹⣿⡆⠀⠀⠀⠀⠀⠀⠀⠀⠀⠀⠀⠀⠀⠀⠀⠀⠀⢠⣎⣠⣴⠿⠃⠀⠀⠀
⠀⢀⣠⠔⠒⠈⠉⠀⠹⣿⣄⠀⠀⠀⠀⠀⠀⠀⠀⠀⠀⠀⠀⠀⠀⠀⣠⠾⠛⠛⠉⠒⠢⣄⠀⠀
⠀⣿⡁⠀⠀⠀⠀⠀⠀⠈⢻⣦⡀⠀⠀⠀⠀⠀⠀⠀⠀⠀⠀⠀⣀⣾⡃⠀⠀⠀⠀⠀⠀⠀⡟⠀
⠀⠙⠻⣶⣀⠀⠀⠀⠀⠀⠀⠈⠙⠲⠦⣤⣄⣀⣀⣀⣤⣤⣾⣯⡵⠞⠋⠀⠀⠀⣀⠟⠀⠀⠀⠀
⠀⠀⠀⠀⠉⠛⠻⠿⠿⠶⠶⠤⠤⠤⣄⣀⣀⣀⣀⣀⣀⣀⣀⡠⠤⠤⠤⠴⠖⠉⠀⠀⠀⠀⠀⠀