⬛⬛🟦⬜⬜🟨🟨🟦🟩⬛⬛⬛⬛⬜⬛⬛⬛⬛⬜⬜⬜⬛🟦⬛⬛🟩🟩🟩⬛🟦🟦🟦⬛⬛🟦⬜🟩🟩⬛⬛🟦🟦🟦🟦⬛🟦🟦⬜⬛🟩⬛⬛🟩🟩⬜⬜⬛⬜🟦⬛
⬜⬛🟦⬜⬜🟨⬜⬜⬛⬛⬛⬛⬛⬛⬛🟩🟦🟩⬜⬜⬛⬜🟩⬜🟨⬛🟩🟦⬛🟦⬛⬛⬛⬛⬜🟨⬜⬜⬜⬛🟦🟦🟦⬛⬛🟦🟦⬛⬛⬜⬜⬜⬜⬜⬜⬜⬜⬜⬜⬜
⬜🟦🟦⬛⬜🟩🟦🟦⬛🟦⬛⬛⬛⬛🟦🟩🟦⬛🟩🟦⬛⬛⬛⬛⬛⬛⬛⬛🟩🟩⬛🟦⬛🟩⬜⬜🟨⬜⬜⬛⬛⬛⬛🟦🟦🟦🟩🟩⬜⬜⬜🟨⬜🟨🟨🟨⬜⬜⬛⬜
🟦⬛⬛🟦🟦🟦🟩🟦🟦🟦⬛⬛🟨🟨🟩⬛🟦⬛⬛🟦⬛⬛⬛🟩⬛⬛⬛🟩⬛⬛⬛🟦🟦⬛⬛🟩🟩⬛⬛⬛⬛🟦⬛⬛🟦⬛🟦⬜⬜⬜🟨⬜🟨🟨⬜⬜⬜⬜⬜⬜
🟩🟦🟦🟦🟦🟩🟦⬛🟦🟩⬛⬛⬜🟨🟨⬛⬛🟦⬛⬛🟦🟩⬛⬜⬜⬜⬜⬜⬜🟩⬜🟩⬜⬜⬜⬛⬛⬛🟩⬛🟩🟩⬜🟩🟩🟩🟦🟩⬜🟨⬜🟨🟨🟨⬜🟨🟨🟨⬜🟩
⬜⬜🟩🟦🟩🟦🟦🟦🟦🟦⬛⬜⬜⬜🟩⬛⬛🟩🟩🟩🟩🟩⬜🟨⬜⬜⬜⬜🟨⬜🟩⬛🟩⬛🟩🟩🟩⬛⬛🟩⬜⬜⬜⬜⬜🟦🟦🟦⬜⬜⬜⬜🟨🟨🟨🟨🟨⬜⬜⬜
⬜⬜⬜🟦⬛⬛⬛⬛🟦⬛⬛⬛🟩🟩⬜⬜🟦⬜⬜🟩⬜⬜⬜🟩⬜⬛🟦🟩🟦⬛⬛⬜🟩🟦🟦⬜🟦🟩⬛⬛🟨🟩⬜⬜⬜🟦⬛🟦🟩⬜🟩⬜⬜⬜⬜⬜⬜🟨⬜🟩
⬜🟩⬜⬜⬜⬜🟩🟩⬜⬜⬛⬛⬜⬜🟩⬜🟩🟩🟩⬜🟩⬛⬛⬛🟩⬜⬜🟩🟩🟦🟩🟩🟩🟩🟩⬛⬛⬛🟩🟦🟦🟦🟩⬛🟩🟩🟩🟦🟩🟩⬜⬜⬜⬜⬜🟨⬜🟩🟩🟩
🟩⬜⬜🟩🟩⬜⬜⬜⬜⬜⬛⬛⬜⬜🟩⬜⬜⬜⬜⬜🟩⬛⬛🟩🟩⬜🟩🟩🟩🟦⬜🟩⬛🟩🟩⬜🟩⬛⬛🟩⬛⬛⬜🟦⬜🟩⬛⬛⬜⬛⬛🟦🟩🟩🟦🟦⬛🟦🟩🟦
🟩⬜⬜⬜⬜⬜🟩⬜🟩🟩⬛⬛⬛⬜🟩⬛🟩🟩🟨🟩⬛🟩⬜🟩🟩🟦🟦⬜⬜⬛🟦⬜⬜⬜⬜⬜⬛⬛🟦⬛🟩⬛⬛⬛⬛⬛⬛🟩🟩🟩⬛🟩⬛⬛🟦🟩⬛⬛🟦⬜
⬜⬜⬜⬜⬜⬜🟩⬜⬛⬛⬛⬛⬛⬛⬛⬛⬛⬛⬛⬛⬛🟩🟩⬜⬜🟩🟩⬛🟩🟩⬛🟩⬛⬛🟦🟩🟩🟩⬛⬜⬛⬜🟩⬜🟩🟩⬛⬛🟦🟩🟩⬛⬛🟩🟩🟩⬜⬜⬜⬜
🟦⬜⬜🟦⬛🟦🟩🟩⬛⬛⬛⬛⬛⬛⬛⬛🟩⬛⬛⬛🟩🟩⬜⬜⬜🟩⬜⬜⬜⬛⬛⬛⬛⬛⬛🟨🟩⬜⬛⬛⬛⬛⬛⬛⬜🟩🟩⬛⬛🟦🟩⬜⬜⬜⬜⬜⬜⬜⬜⬜
🟩⬜⬜🟩🟩🟩⬜🟨⬛⬛⬛⬛⬛⬛🟩⬛🟩⬜⬜⬜⬜⬜🟩⬜🟩🟩⬛🟩⬛⬜🟩⬛⬜🟩⬛⬛🟦🟩⬜⬜🟦⬛🟩⬜⬛⬛⬛🟩🟩⬜🟩⬜⬜⬜⬜⬜⬜⬜⬜🟩
🟩🟩⬛🟩🟩🟩🟨🟨⬛⬛⬛⬛⬛⬛🟦🟩⬛⬜⬜⬜⬜⬜⬜⬜🟩⬛⬛🟩⬜⬛⬛⬛🟩⬛⬛🟩⬛🟩⬛⬜⬛🟩⬛⬛🟩⬛⬛🟨⬜⬜⬜⬜🟩⬛🟩⬜⬜⬛⬛⬛
⬛⬜🟩🟦🟩🟦🟦🟦⬛⬛⬛⬛⬛⬛🟩🟩⬛⬜⬜⬜⬜⬜⬜⬜⬜⬛🟩⬛🟦🟩⬛🟩🟦⬛⬛⬛⬛⬛🟩🟩🟩⬛⬛🟩🟦⬜⬜⬜🟩⬜🟨🟩⬛⬜⬛⬛⬛⬛⬛⬛
⬛⬛⬜⬜🟩🟦⬛🟦⬛⬛⬛⬛⬛⬛🟦⬛🟩⬜⬜⬜⬜⬜⬜⬜🟩⬛🟦🟦⬜⬜⬜🟩🟩⬜⬜⬜⬜🟩🟩⬜⬜🟩⬜🟩🟩🟩🟩🟩⬛🟩🟩🟨⬜⬛⬛⬛⬛⬛⬛⬛
🟩🟩⬛⬜⬜⬜🟩🟦⬛⬛⬛⬛⬛⬛⬛⬛⬛⬛🟩⬜🟩🟩🟨⬜⬜⬜⬜🟩⬜🟩⬜⬜🟩⬜⬛⬛⬛⬜🟩🟩⬜⬜⬜🟩⬛⬛⬛⬛⬛⬛⬛⬛⬛⬛🟦🟦🟦🟦🟩⬛
🟩🟩⬜🟩⬜⬜🟩🟩⬛⬛⬛⬛⬛⬛⬛⬛⬛⬛🟩🟩⬜⬜🟩⬛🟩⬛⬛⬛🟩🟩🟩⬛⬛⬜⬛⬛⬛⬛⬛⬛⬛⬛⬛⬛⬛⬛⬛⬛⬛⬛⬛⬛⬛🟩⬛🟩🟦⬛🟩🟦
🟦🟦🟦🟩⬜⬛⬜🟩⬛⬛⬛⬛⬛⬛⬛⬛⬛⬛⬛⬛⬛⬛🟩⬛⬜⬛⬛⬛🟩🟩🟩⬛⬛⬛⬛⬛⬛⬛⬛⬛⬛⬛⬛⬛⬛⬛⬛🟦⬛🟦⬛⬛🟩⬛🟩🟩🟦🟦🟦🟦
⬛⬛⬛🟦🟩⬜🟦🟩⬛⬛⬛⬛⬛⬛⬛⬛⬛⬛⬛⬛⬛⬛⬛⬛⬛🟦⬛⬛⬛⬛🟩⬛⬛⬛🟦🟦⬛⬛⬛🟦🟩⬛⬛⬛⬛🟩⬛⬛🟩⬛⬛⬛⬛⬜⬛⬛⬛⬛⬛⬛
⬛⬛⬛⬛⬛⬛⬛⬛⬛⬛⬛⬛⬛⬛⬛⬛⬛⬛⬛⬛⬛⬛⬛⬛⬛⬛⬛⬛⬛🟩⬛🟩🟩⬛⬛⬛🟦🟩⬛⬛⬛⬛🟩⬛🟩🟩⬛🟦⬛⬛🟦⬛⬛⬛⬜⬜⬜🟩⬛⬜
⬛⬛⬛⬛⬛⬛⬛⬛⬛⬛⬛⬛⬛⬛⬛⬛⬛⬛⬛⬛⬛⬛⬛⬛⬛🟩🟦🟦⬛⬛⬛🟩⬛⬛🟩⬛⬛🟦🟩⬛⬛⬛⬛⬛⬛⬛⬛⬛⬛⬛🟩⬛⬛🟩🟩⬛⬛⬛🟩🟩
⬛⬛⬛🟩⬛⬛⬛⬛⬛⬛⬛⬛⬛⬛⬛⬛⬛⬛⬛⬛⬛⬛⬛⬛⬛⬛⬛⬛⬛⬛⬛⬛⬛🟩⬛⬛⬜⬛⬛⬛⬛⬛⬛⬛⬛⬛⬛⬛⬛⬛⬛🟩⬛🟩⬛⬛⬛⬛⬛⬛
⬛⬛⬛⬛⬛⬛⬛⬛⬛⬛⬛⬛⬛⬛⬛⬛⬛⬛⬛⬛⬛⬛⬛⬛⬛⬛⬛⬛⬛⬛⬛⬛⬜🟩🟦⬛⬛⬛⬛⬛⬛⬛⬛⬛⬛🟦🟨⬛⬛⬛⬛⬛⬛⬛⬛⬛🟩⬛⬛⬛
⬛⬛🟦⬛⬛🟩🟩⬛⬛⬛⬛⬛⬛⬛⬛⬛⬛⬜⬛⬛⬛⬛⬛⬛⬛⬛⬛⬛⬛⬛⬛⬛🟩⬛⬛⬛⬛⬛⬛⬛⬛⬛⬛⬛⬛⬛⬛⬛⬛🟨⬜⬛⬛⬛⬛⬛🟩⬛⬛🟩
⬛⬛⬛⬛🟨🟩🟩⬛⬛⬛⬛⬛⬛⬛⬛⬛⬛⬛⬛⬛⬛⬛⬛⬛⬛⬛⬛⬛⬛🟩🟩⬛🟩🟩🟨⬛⬛⬛⬛⬛🟦⬛🟩⬛🟩⬛⬛⬛⬛⬛⬛🟩🟦🟦⬛⬛⬛⬛⬛⬜
⬛⬛⬛🟩⬛⬛⬛⬛⬛⬛⬛⬛⬛🟩⬛⬛⬛⬛⬛⬛⬛⬛⬛⬛⬛⬛⬛⬜🟩⬛⬛⬛⬛⬛⬛⬛⬛⬛⬛⬛⬛⬜🟩🟩🟩⬛⬛⬛⬛⬛⬛⬛⬛🟩⬛⬛⬛⬛⬛⬛